0000000000000000000000000000000000000000
0000000000000000000000000000000000000000
0011111111100000000000000000000000000000
0010000000100000000000000000000000000000
0010111111100000000000011110000000000000
0010100000000000000000100001000000000000
0010100000000000000000101101000000000000
0010111100000000000000101101000000000000
0010000100001111111000100001000000000000
0010111100001000001000101110000000000000
0010100000001111101000101000000000000000
0010100000000000101000101000000000000000
0010100000000000101000101000000000000000
0010100000000000101000101000000000000000
0010100000000000101000111000000000000000
0010100000000000101000000000000000000000
0011100000011000101000011111110000000000
0000000000010101101000010000010000000000
0000000000010011001000010111110000000000
0000000000001000011000010100000011111000
0000000000001111110000010100000010001000
0000000000000000000000010101110011101000
0000000000000000000000010110001000101000
0000000000000000000000010001010000101000
0000000000000000000000001100010000101000
0000000000000000000000000111110110101000
0000000000000000000000000000000101001000
0000000000000000000000000000000100010000
0000000000000000000000000000000011110000
0000000000000000000000000000000000000000
