0000000000000000000000000000000000000000
0000000000000000000000001100000000000000
0000000000000000000111010011000000000000
0131000000000000000100110000110000012100
0111000000000000000100000000010000011100
0000000000000000000010001000001000B00000
0000000000000000001100010100010000000000
0000000000000000001000100100100000000000
0000000000010000001000011000110000000000
0000000000001100001110000100010000000000
0000011001000010000001001111110000000000
0000100100110001100010001010000000000000
0001000010001010011001111001000000000000
0001000001000100100100000001001110000000
0011100001111101000100111001001110000000
0010010000101100010100111101011110000000
0011001101001110110100111101111100000000
0001100111000111001000011111110000000000
0000011101100011110000001111000000000000
0000001001110001110000000001000000000000
0000111000111000110000000001000000000000
0000101100011111100000000001000000000000
0001101110001100100000000001000000000000
0A01000111011100010000000011000000000000
0001100011110010010000000011100000000000
0000110011010001010000001110110000000111
0001101100001001000000001100011000001111
0011000000001010000000001000001000011111
0010000000010000000000000000000001111111
0000000000000000000000000000000011111111
