1111111111111111111111111111111111111111
1111000100000000000000000000000000001111
1110000100000000000000000000000000000111
110A000100000000000000000000000000000011
1000000100000000000000000000000000000001
1000000100000000000000000000000000000001
1000000011111111110000000000000000000001
1111110000000000010000000000000000000001
1000001000000000010000000000000000000001
1000000100000000010000000000000000000001
1000000010000000010000000000000000000001
1000000010000000010000000000000000000001
1000000010000000011111111000000000000001
1000000010000000010000001000000000000001
1000000010000000010000001000000000000001
1000000011111111110000001000000000000001
1000000000000010000000001000000000000001
1000000000000010000000001000000000000001
1000000000000010000320001111111000000001
1000000000000010000000001000000100000001
1000000000000010000000001000000010000001
1000000000000010000000001000000001000001
1000000000000011111111111000000000111111
1000000000000000000010000000000000000001
1000000000000000000010000000111100000001
100000000000000000001000000100001000B001
1100000000000000000010000001000010000011
1110000000000000000011111111111110000111
1111000000000000000000000000000010001111
1111111111111111111111111111111111111111
